1111111111000000000000000000000000000000000000
1222222221111111111111111111111111111111111111
1222222222222222222222222222222222222222222221
1222222222222222222222222222222222222222222221
1222222222222222222222222222222222222222222221
1222222222222222222222222222222222222222222221
1111111111111111111222222221111133111111111411
0000000000000000001222212221000133100000001110
0000000000000000001222222221000133100000000000
0000000000000000001222222221000133100000000000
0000000000000000001111111111000111100000000000